Assault	Battery
Boom	Bust
Bound	Determined
Crime	Punishment
Dead	Gone
Fire	Ice
Hide	Seek
Hit	Run
Illusion	Reality
Life	Death
Night	Day
Odds	Ends
Order	Chaos
Pain	Suffering
Pure	Simple
Research	Development
Rise	Fall
Rough	Tumble
Spite	Malice
Stand	Deliver
Supply	Demand
Trial	Error
Wax	Wane
